frame7
920
804
boardlv7
2
0 2 2 2 0
0 1 1 1 0
0 1 1 1 0
0 1 1 1 0
0 0 0 1 0
0 0 0 1 0
0 1 1 1 0
0 1 1 1 0
0 1 1 1 0
0 2 2 2 0
